0 1 1 1 1 1 1 1 1 1 1 1 1 
0 1 3 2 4 5 5 5 5 5 4 2 1
0 1 3 3 2 4 5 5 5 4 2 3 1
0 1 0 3 3 2 4 5 4 2 3 3 1
0 0 0 0 0 0 0 0 0 0 0 0 1
0 1 0 3 3 2 4 5 4 2 3 3 1
0 1 3 3 2 4 5 5 5 4 2 3 1
0 1 3 2 4 5 5 5 5 5 4 2 1
0 1 1 1 1 1 1 1 1 1 1 1 1